[
[ 3,3,3,3,3,0,0,0,0,0,0,0,0,0,0,0,0,0,0,0,0,0,0,0,0,0,0,0,0,0,0,0,0,0,0,0,0],
[ 0,0,0,0,0,0,0,0,0,0,0,0,0,0,0,0,0,0,0,0,0,0,0,0,0,0,0,0,0,0,0,0,0,0,0,0,0],
[ 0, 0, 0,0,0,0,0,0,0,0,0,0,0,0,0,0,0,21,22,1,1, 8, 9,0,0,0,0,0,0,0,0,0,0,0,0,0,0],
[ 0, 0, 0,0,0,0,0,0,0,0,0,0,0,0,0,0,0,20, 2,2,2,10,11,0,0,0,0,0,0,0,0,0,0,0,0,0,0],
[ 0, 0, 0,0,0,0,0,0,0,0,0,0,0,0,0,0,0,19, 3,3,3,12,11,0,0,0,0,0,0,0,0,0,0,0,0,0,0],
[ 0, 0, 0,0,0,0,0,0,0,0,0,0,0,0,0,0,0,19, 3,3,3,12,11,0,0,0,0,0,0,0,0,0,0,0,0,4,0],
[ 21,22,1,1,1,1,1,1,1,1,1,1,1,1,1,1,1,17, 3,3,3,13,15,1,1,1,1,1,1,1,1,1,1,1,1,1,1],
[ 20, 2,2,2,2,2,2,2,2,2,2,2,2,2,2,2,2,18, 3,3,3,14,16,2,2,2,2,2,2,2,2,2,2,2,2,2,2],
[ 19,3,3,3,3,3,3,3,3,3,3,3,3,3,3,3,3,3,3,3,3,3,3,3,3,3,3,3,3,3,3,3,3,3,3,3,3],
[ 19,3,3,3,3,3,3,3,3,3,3,3,3,3,3,7,3,3,3,3,3,3,3,3,3,3,3,3,3,3,3,3,3,3,3,3,3],
[ 19,3,3,3,3,3,3,3,3,3,3,3,3,3,3,3,3,3,3,3,3,3,3,3,3,3,3,3,3,3,3,3,3,3,3,3,3],
[ 19,3,3,3,3,3,3,3,3,3,3,3,3,3,3,3,3,3,3,3,3,3,3,3,3,3,3,3,3,3,3,3,3,3,3,3,3],
[ 19,3,3,3,3,3,3,3,7,3,3,3,3,3,3,3,3,3,3,3,3,3,3,3,3,6,3,3,3,3,3,3,3,3,3,3,3],
[ 19,3,3,3,3,3,3,3,3,3,3,3,3,3,3,3,3,3,3,3,3,3,3,3,3,3,3,3,3,3,3,3,3,3,3,3,3],
[ 19,3,3,3,3,3,3,3,3,3,3,3,3,3,3,4,3,3,3,3,3,3,3,3,3,3,3,3,3,3,3,3,3,3,3,3,3],
[ 19,4,3,3,3,3,3,3,3,3,3,3,3,3,3,3,3,3,3,3,3,3,3,3,3,3,3,3,3,3,3,3,3,3,3,3,3],
[ 19,3,3,3,3,3,3,3,3,3,3,3,3,3,3,3,3,3,3,3,3,3,3,3,3,3,3,3,3,3,3,3,3,3,3,3,3],
[ 19,3,3,3,3,3,3,3,3,3,3,3,3,3,3,3,3,3,3,3,3,3,3,3,3,3,3,3,3,3,7,3,3,3,3,3,3],
[ 19,3,3,3,3,3,3,3,3,3,3,3,3,3,3,3,3,3,3,3,3,3,3,3,3,3,3,3,3,3,3,3,3,3,3,3,3],
[ 19,3,3,3,3,3,3,3,3,3,3,3,3,3,3,3,3,3,3,3,3,3,3,3,3,3,3,3,3,3,3,3,3,3,3,3,3],
[ 19,3,3,3,3,3,3,3,3,3,3,3,3,3,3,3,3,3,3,3,3,3,3,3,3,3,3,3,3,3,3,3,3,3,3,3,3],
[ 19,3,3,3,3,3,3,3,3,3,3,3,3,3,3,3,3,3,3,3,3,3,3,3,3,3,3,3,3,3,3,3,3,3,3,3,3],
[ 19,3,3,3,3,3,3,3,3,3,3,3,3,3,3,3,3,3,3,3,3,3,3,3,3,3,3,3,3,3,3,3,3,3,3,3,3]
]
